,partner,sub3,reg,new,rep,total,ARn,RLS
1201,LEADGID,58461,2186,1107,3203,4310,0.51,0.7431554524361949
73530,RAFINAD,,2656,953,1993,2946,0.36,0.676510522742702
868,LEADGID,12950,854,408,1112,1520,0.48,0.7315789473684211
1194,LEADGID,57766,578,332,1107,1439,0.57,0.7692842251563586
1814,LEADS,154244,2040,1065,274,1339,0.52,0.2046303211351755
95377,UNICOM24,41476,1450,799,308,1107,0.55,0.27822944896115626
1040,LEADGID,33203,718,386,704,1090,0.54,0.6458715596330276
275,CITYADS,5eDh,90,280,578,858,3.11,0.6736596736596736
476,GURU,121,686,276,528,804,0.4,0.6567164179104478
986,LEADGID,29873,139,160,547,707,1.15,0.7736916548797736
1199,LEADGID,58238,741,316,301,617,0.43,0.4878444084278768
950,LEADGID,26769,518,232,362,594,0.45,0.6094276094276094
1203,LEADGID,58463,206,139,430,569,0.67,0.7557117750439367
495,GURU,1633,881,249,285,534,0.28,0.5337078651685393
1713,LEADS,148076,115,97,432,529,0.84,0.8166351606805293
241,ARHIP,,25,282,110,392,11.28,0.28061224489795916
866,LEADGID,12428,101,153,197,350,1.51,0.5628571428571428
156,ADMITAD,52519,119,225,120,345,1.89,0.34782608695652173
18,ADMITAD,1146051,109,113,215,328,1.04,0.6554878048780488
861,LEADGID,10392,153,84,227,311,0.55,0.729903536977492
1082,LEADGID,37193,156,97,212,309,0.62,0.686084142394822
339,CITYADS,sp3,73,102,203,305,1.4,0.6655737704918033
1982,LEADS,17890,54,97,206,303,1.8,0.6798679867986799
1593,LEADS,137169,90,58,216,274,0.64,0.7883211678832117
1783,LEADS,152795,98,52,170,222,0.53,0.7657657657657657
586,GURU,3614,392,181,36,217,0.46,0.16589861751152074
978,LEADGID,28789,137,58,150,208,0.42,0.7211538461538461
1701,LEADS,147178,105,43,164,207,0.41,0.7922705314009661
1097,LEADGID,37913,70,47,151,198,0.67,0.7626262626262627
1004,LEADGID,32183,94,78,117,195,0.83,0.6
252,CITYADS,27EF,40,77,106,183,1.92,0.5792349726775956
636,GURU,4680,370,168,7,175,0.45,0.04
1697,LEADS,146789,286,133,35,168,0.47,0.20833333333333334
2132,LEADS,58218,303,142,26,168,0.47,0.15476190476190477
1202,LEADGID,58462,74,37,113,150,0.5,0.7533333333333333
1522,LEADS,128457,20,17,129,146,0.85,0.8835616438356164
159,ADMITAD,539733,127,129,16,145,1.02,0.1103448275862069
1533,LEADS,129416,308,131,13,144,0.43,0.09027777777777778
1739,LEADS,149351,24,21,121,142,0.88,0.852112676056338
1724,LEADS,148603,35,19,116,135,0.54,0.8592592592592593
1756,LEADS,150413,51,22,107,129,0.43,0.8294573643410853
1075,LEADGID,36443,57,31,91,122,0.54,0.7459016393442623
1711,LEADS,147990,37,23,98,121,0.62,0.8099173553719008
1512,LEADS,127377,19,17,97,114,0.89,0.8508771929824561
2073,LEADS,46928,212,108,4,112,0.51,0.03571428571428571
1555,LEADS,132630,48,18,93,111,0.38,0.8378378378378378
653,GURU,5051,71,25,83,108,0.35,0.7685185185185185
1730,LEADS,148925,18,16,84,100,0.89,0.84
1028,LEADGID,32663,28,19,81,100,0.68,0.81
1057,LEADGID,35153,4,77,21,98,19.25,0.21428571428571427
326,CITYADS,mwxJzG,109,51,47,98,0.47,0.47959183673469385
1286,LEADGID,64416,147,93,5,98,0.63,0.05102040816326531
594,GURU,3793,16,11,85,96,0.69,0.8854166666666666
679,GURU,5808,14,12,84,96,0.86,0.875
1605,LEADS,138800,13,12,79,91,0.92,0.8681318681318682
1031,LEADGID,32723,47,20,70,90,0.43,0.7777777777777778
608,GURU,4085,34,20,62,82,0.59,0.7560975609756098
1448,LEADGID,75490,37,25,56,81,0.68,0.691358024691358
1872,LEADS,157560,14,14,66,80,1.0,0.825
2105,LEADS,50985,132,73,6,79,0.55,0.0759493670886076
1688,LEADS,146348,129,54,22,76,0.42,0.2894736842105263
1055,LEADGID,35041,37,15,61,76,0.41,0.8026315789473685
1180,LEADGID,56192,9,10,64,74,1.11,0.8648648648648649
987,LEADGID,30061,54,20,52,72,0.37,0.7222222222222222
1189,LEADGID,57343,32,17,55,72,0.53,0.7638888888888888
1626,LEADS,140766,20,15,57,72,0.75,0.7916666666666666
481,GURU,1484,110,46,25,71,0.42,0.352112676056338
1603,LEADS,138622,97,65,6,71,0.67,0.08450704225352113
2156,LEADS,75911,37,19,51,70,0.51,0.7285714285714285
1633,LEADS,141105,41,15,54,69,0.37,0.782608695652174
1475,LEADS,124106,30,11,57,68,0.37,0.8382352941176471
984,LEADGID,29519,29,10,57,67,0.34,0.8507462686567164
1528,LEADS,128702,15,16,51,67,1.07,0.7611940298507462
681,GURU,5811,21,15,51,66,0.71,0.7727272727272727
1009,LEADGID,32281,32,17,46,63,0.53,0.7301587301587301
1025,LEADGID,32657,22,21,42,63,0.95,0.6666666666666666
1726,LEADS,148651,20,9,53,62,0.45,0.8548387096774194
1408,LEADGID,70545,29,19,41,60,0.66,0.6833333333333333
73435,LIKNOT,4574,82,56,0,56,0.68,0.0
1323,LEADGID,66491,24,18,36,54,0.75,0.6666666666666666
1765,LEADS,151237,81,54,0,54,0.67,0.0
1608,LEADS,139154,79,51,3,54,0.65,0.05555555555555555
1670,LEADS,144910,95,44,10,54,0.46,0.18518518518518517
1482,LEADS,124578,26,17,36,53,0.65,0.6792452830188679
1565,LEADS,133972,31,21,31,52,0.68,0.5961538461538461
1211,LEADGID,59189,19,13,39,52,0.68,0.75
1899,LEADS,158407,86,50,2,52,0.58,0.038461538461538464
1021,LEADGID,32527,22,13,37,50,0.59,0.74
1492,LEADS,125355,39,16,34,50,0.41,0.68
123,ADMITAD,2506,29,44,6,50,1.52,0.12
73736,SALEADS,de5ed0d0-c98f-11e9-9356-13b4824cb393,70,50,0,50,0.71,0.0
269,CITYADS,58ZYo8,110,46,3,49,0.42,0.061224489795918366
2144,LEADS,66417,5,11,37,48,2.2,0.7708333333333334
2129,LEADS,53345,27,17,31,48,0.63,0.6458333333333334
1094,LEADGID,37901,31,12,34,46,0.39,0.7391304347826086
1496,LEADS,125754,24,11,34,45,0.46,0.7555555555555555
1976,LEADS,168868,23,14,31,45,0.61,0.6888888888888889
327,CITYADS,nZypxl,83,42,2,44,0.51,0.045454545454545456
1987,LEADS,18956,46,18,26,44,0.39,0.5909090909090909
1869,LEADS,157527,26,12,32,44,0.46,0.7272727272727273
95195,UNICOM24,16233,15,18,25,43,1.2,0.5813953488372093
1402,LEADGID,70539,26,15,28,43,0.58,0.6511627906976745
1406,LEADGID,70543,20,14,29,43,0.7,0.6744186046511628
535,GURU,2452,22,6,37,43,0.27,0.8604651162790697
73407,LEADTARGET,794,134,20,22,42,0.15,0.5238095238095238
1484,LEADS,124688,12,14,28,42,1.17,0.6666666666666666
1072,LEADGID,36435,41,14,27,41,0.34,0.6585365853658537
1081,LEADGID,37191,33,13,28,41,0.39,0.6829268292682927
311,CITYADS,O7xWXg,5,6,35,41,1.2,0.8536585365853658
1630,LEADS,140837,26,12,28,40,0.46,0.7
1274,LEADGID,63437,16,9,31,40,0.56,0.775
206,ADMITAD,960004,0,12,27,39,inf,0.6923076923076923
1400,LEADGID,70536,16,13,26,39,0.81,0.6666666666666666
590,GURU,3767,3,2,36,38,0.67,0.9473684210526315
1317,LEADGID,66345,5,8,30,38,1.6,0.7894736842105263
1818,LEADS,154584,60,34,3,37,0.57,0.08108108108108109
1388,LEADGID,70098,7,5,32,37,0.71,0.8648648648648649
2021,LEADS,29269,27,11,26,37,0.41,0.7027027027027027
706,GURU,6356,21,12,25,37,0.57,0.6756756756756757
1677,LEADS,145787,77,33,4,37,0.43,0.10810810810810811
1338,LEADGID,67375,12,11,25,36,0.92,0.6944444444444444
668,GURU,5440,79,35,1,36,0.44,0.027777777777777776
2104,LEADS,50944,47,31,3,34,0.66,0.08823529411764706
2008,LEADS,23706,83,12,22,34,0.14,0.6470588235294118
1014,LEADGID,32337,23,5,29,34,0.22,0.8529411764705882
1324,LEADGID,66493,42,27,7,34,0.64,0.20588235294117646
1320,LEADGID,66486,16,9,24,33,0.56,0.7272727272727273
1048,LEADGID,34179,11,2,31,33,0.18,0.9393939393939394
1052,LEADGID,34553,13,4,29,33,0.31,0.8787878787878788
277,CITYADS,5ohl,29,9,24,33,0.31,0.7272727272727273
2155,LEADS,75828,19,9,23,32,0.47,0.71875
1790,LEADS,153044,38,30,2,32,0.79,0.0625
316,CITYADS,X6K4OA,58,30,2,32,0.52,0.0625
1407,LEADGID,70544,19,10,22,32,0.53,0.6875
1196,LEADGID,57865,10,3,28,31,0.3,0.9032258064516129
1399,LEADGID,70535,27,12,19,31,0.44,0.6129032258064516
1322,LEADGID,66489,41,29,2,31,0.71,0.06451612903225806
989,LEADGID,30711,8,4,27,31,0.5,0.8709677419354839
1012,LEADGID,32287,9,10,20,30,1.11,0.6666666666666666
1616,LEADS,140234,10,12,18,30,1.2,0.6
1280,LEADGID,64036,12,8,22,30,0.67,0.7333333333333333
943,LEADGID,25799,15,7,23,30,0.47,0.7666666666666667
1958,LEADS,164383,52,28,1,29,0.54,0.034482758620689655
1719,LEADS,148452,32,17,12,29,0.53,0.41379310344827586
1504,LEADS,126547,5,4,25,29,0.8,0.8620689655172413
926,LEADGID,24711,7,6,23,29,0.86,0.7931034482758621
1480,LEADS,124482,20,7,22,29,0.35,0.7586206896551724
1209,LEADGID,58993,9,10,19,29,1.11,0.6551724137931034
704,GURU,6321,10,8,21,29,0.8,0.7241379310344828
2128,LEADS,53292,12,8,20,28,0.67,0.7142857142857143
1748,LEADS,149842,55,28,0,28,0.51,0.0
1019,LEADGID,32521,18,6,22,28,0.33,0.7857142857142857
2106,LEADS,50988,0,7,21,28,inf,0.75
2072,LEADS,46818,48,20,7,27,0.42,0.25925925925925924
1479,LEADS,124449,7,3,24,27,0.43,0.8888888888888888
993,LEADGID,30979,9,8,19,27,0.89,0.7037037037037037
914,LEADGID,23487,104,12,14,26,0.12,0.5384615384615384
717,GURU,6658,21,6,20,26,0.29,0.7692307692307693
1718,LEADS,148401,28,19,7,26,0.68,0.2692307692307692
604,GURU,4036,13,7,19,26,0.54,0.7307692307692307
95392,UNICOM24,70740,36,24,2,26,0.67,0.07692307692307693
1262,LEADGID,62379,11,7,19,26,0.64,0.7307692307692307
1601,LEADS,138336,22,8,18,26,0.36,0.6923076923076923
1298,LEADGID,64845,32,23,2,25,0.72,0.08
1698,LEADS,146840,42,22,2,24,0.52,0.08333333333333333
569,GURU,3350,10,4,20,24,0.4,0.8333333333333334
1673,LEADS,145446,54,22,2,24,0.41,0.08333333333333333
1668,LEADS,144779,37,24,0,24,0.65,0.0
1643,LEADS,141913,35,23,1,24,0.66,0.041666666666666664
509,GURU,2071,9,6,18,24,0.67,0.75
1615,LEADS,140208,21,7,16,23,0.33,0.6956521739130435
1403,LEADGID,70540,16,7,16,23,0.44,0.6956521739130435
1404,LEADGID,70541,10,7,16,23,0.7,0.6956521739130435
1570,LEADS,134438,7,6,17,23,0.86,0.7391304347826086
916,LEADGID,23527,9,4,19,23,0.44,0.8260869565217391
1405,LEADGID,70542,14,4,19,23,0.29,0.8260869565217391
282,CITYADS,76KGrr,12,9,13,22,0.75,0.5909090909090909
1674,LEADS,145563,27,19,3,22,0.7,0.13636363636363635
1870,LEADS,157551,8,8,14,22,1.0,0.6363636363636364
1874,LEADS,157563,5,6,16,22,1.2,0.7272727272727273
1164,LEADGID,52624,25,20,1,21,0.8,0.047619047619047616
1010,LEADGID,32283,9,4,17,21,0.44,0.8095238095238095
575,GURU,3434,36,18,2,20,0.5,0.1
318,CITYADS,Z4M21E,22,19,1,20,0.86,0.05
1309,LEADGID,65981,25,19,1,20,0.76,0.05
892,LEADGID,21627,26,12,8,20,0.46,0.4
568,GURU,3344,20,12,8,20,0.6,0.4
771,GURU,9687,29,20,0,20,0.69,0.0
2099,LEADS,50080,10,6,14,20,0.6,0.7
1546,LEADS,130978,5,2,18,20,0.4,0.9
1867,LEADS,157504,9,3,17,20,0.33,0.85
940,LEADGID,25717,6,4,16,20,0.67,0.8
1223,LEADGID,59539,9,4,16,20,0.44,0.8
1996,LEADS,20602,14,5,14,19,0.36,0.7368421052631579
73545,RAFINAD,1778,5,2,17,19,0.4,0.8947368421052632
1792,LEADS,153162,7,3,16,19,0.43,0.8421052631578947
1789,LEADS,153043,29,17,2,19,0.59,0.10526315789473684
1225,LEADGID,59555,10,3,16,19,0.3,0.8421052631578947
1265,LEADGID,62653,8,3,16,19,0.38,0.8421052631578947
612,GURU,4092,11,7,11,18,0.64,0.6111111111111112
603,GURU,4031,9,4,14,18,0.44,0.7777777777777778
1517,LEADS,127637,22,17,1,18,0.77,0.05555555555555555
574,GURU,3429,66,7,11,18,0.11,0.6111111111111112
2111,LEADS,51414,7,6,12,18,0.86,0.6666666666666666
1893,LEADS,158156,24,17,1,18,0.71,0.05555555555555555
1703,LEADS,147430,24,15,3,18,0.62,0.16666666666666666
1190,LEADGID,57368,10,2,15,17,0.2,0.8823529411764706
1489,LEADS,125066,8,5,12,17,0.62,0.7058823529411765
927,LEADGID,24715,7,4,13,17,0.57,0.7647058823529411
1978,LEADS,1698,6,4,13,17,0.67,0.7647058823529411
95338,UNICOM24,19370,19,7,10,17,0.37,0.5882352941176471
73585,RAFINAD,668,7,7,10,17,1.0,0.5882352941176471
254,CITYADS,2Keh,50,8,9,17,0.16,0.5294117647058824
1252,LEADGID,61672,7,4,13,17,0.57,0.7647058823529411
1862,LEADS,157214,6,4,12,16,0.67,0.75
997,LEADGID,31517,7,3,13,16,0.43,0.8125
1426,LEADGID,71831,19,14,2,16,0.74,0.125
1394,LEADGID,70370,32,14,2,16,0.44,0.125
1875,LEADS,157579,5,3,13,16,0.6,0.8125
73490,PDL-PROFIT,22199,23,15,1,16,0.65,0.0625
1074,LEADGID,36439,11,8,8,16,0.73,0.5
73588,RAFINAD,672,5,6,10,16,1.2,0.625
73480,PDL-PROFIT,17662,27,12,4,16,0.44,0.25
1108,LEADGID,38747,24,12,4,16,0.5,0.25
294,CITYADS,Bg0MrW,29,15,0,15,0.52,0.0
2101,LEADS,50567,27,14,1,15,0.52,0.06666666666666667
1905,LEADS,158625,27,13,2,15,0.48,0.13333333333333333
945,LEADGID,26087,30,15,0,15,0.5,0.0
362,CLICK2MONEY,2560,21,15,0,15,0.71,0.0
1868,LEADS,157506,2,6,9,15,3.0,0.6
217,ADVERTISE,151220,8,15,0,15,1.88,0.0
1821,LEADS,154782,26,14,1,15,0.54,0.06666666666666667
1882,LEADS,157836,21,15,0,15,0.71,0.0
1539,LEADS,130391,9,6,9,15,0.67,0.6
1257,LEADGID,61999,19,13,1,14,0.68,0.07142857142857142
1372,LEADGID,69158,19,14,0,14,0.74,0.0
1918,LEADS,159663,16,13,1,14,0.81,0.07142857142857142
384,CLICK2MONEY,4740,21,14,0,14,0.67,0.0
731,GURU,7125,20,14,0,14,0.7,0.0
1017,LEADGID,32519,11,5,9,14,0.45,0.6428571428571429
656,GURU,5142,27,13,1,14,0.48,0.07142857142857142
73386,LEADTARGET,1218,24,10,4,14,0.42,0.2857142857142857
705,GURU,6333,5,2,12,14,0.4,0.8571428571428571
1027,LEADGID,32661,10,4,10,14,0.4,0.7142857142857143
1852,LEADS,157094,5,4,10,14,0.8,0.7142857142857143
1722,LEADS,148540,1,3,11,14,3.0,0.7857142857142857
858,LEADCRAFT,fb4e4548-f279-4178-b87a-29e6b07c084a,1,3,11,14,3.0,0.7857142857142857
1321,LEADGID,66488,8,7,7,14,0.88,0.5
1212,LEADGID,59191,10,3,11,14,0.3,0.7857142857142857
983,LEADGID,29373,10,3,10,13,0.3,0.7692307692307693
1758,LEADS,150745,17,10,3,13,0.59,0.23076923076923078
1844,LEADS,156775,20,12,1,13,0.6,0.07692307692307693
1581,LEADS,135211,15,12,1,13,0.8,0.07692307692307693
676,GURU,5749,27,12,1,13,0.44,0.07692307692307693
2119,LEADS,52596,11,3,10,13,0.27,0.7692307692307693
1332,LEADGID,67094,21,13,0,13,0.62,0.0
388,CLICK2MONEY,4940,27,13,0,13,0.48,0.0
550,GURU,2887,23,13,0,13,0.57,0.0
795,LEADCRAFT,59b71741-2827-4f3e-bd34-38903f671f2f,24,11,2,13,0.46,0.15384615384615385
1160,LEADGID,50378,14,5,8,13,0.36,0.6153846153846154
1346,LEADGID,67697,16,12,0,12,0.75,0.0
1508,LEADS,127104,28,12,0,12,0.43,0.0
1914,LEADS,159411,19,12,0,12,0.63,0.0
1776,LEADS,152418,14,12,0,12,0.86,0.0
95251,UNICOM24,174711,18,12,0,12,0.67,0.0
1506,LEADS,126801,6,2,10,12,0.33,0.8333333333333334
585,GURU,3590,3,5,7,12,1.67,0.5833333333333334
1391,LEADGID,70220,16,11,1,12,0.69,0.08333333333333333
1254,LEADGID,61747,7,3,9,12,0.43,0.75
394,CLICK2MONEY,5402,11,9,2,11,0.82,0.18181818181818182
724,GURU,6962,3,2,9,11,0.67,0.8181818181818182
1481,LEADS,124551,8,4,7,11,0.5,0.6363636363636364
733,GURU,7208,21,9,2,11,0.43,0.18181818181818182
95247,UNICOM24,174612,29,4,7,11,0.14,0.6363636363636364
1933,LEADS,161400,8,11,0,11,1.38,0.0
1032,LEADGID,32727,16,8,3,11,0.5,0.2727272727272727
1930,LEADS,161152,12,11,0,11,0.92,0.0
1917,LEADS,159626,16,11,0,11,0.69,0.0
1884,LEADS,157914,0,1,10,11,inf,0.9090909090909091
1858,LEADS,157168,9,1,10,11,0.11,0.9090909090909091
1424,LEADGID,71801,15,11,0,11,0.73,0.0
1883,LEADS,157869,1,4,7,11,4.0,0.6363636363636364
1501,LEADS,126448,6,4,7,11,0.67,0.6363636363636364
1494,LEADS,125635,0,3,8,11,inf,0.7272727272727273
73510,PDL-PROFIT,24724,20,9,2,11,0.45,0.18181818181818182
783,LEADCRAFT,22537d20-4684-11ea-8ec9-795ff6d9d45a,26,11,0,11,0.42,0.0
1770,LEADS,151480,16,10,1,11,0.62,0.09090909090909091
2098,LEADS,50017,21,3,8,11,0.14,0.7272727272727273
1766,LEADS,151272,9,8,3,11,0.89,0.2727272727272727
1389,LEADGID,70218,10,8,2,10,0.8,0.2
73535,RAFINAD,116,3,0,10,10,0.0,1.0
73548,RAFINAD,1781,2,1,9,10,0.5,0.9
702,GURU,6299,9,8,2,10,0.89,0.2
1865,LEADS,157346,5,6,4,10,1.2,0.4
1782,LEADS,152773,19,10,0,10,0.53,0.0
1560,LEADS,133613,29,4,6,10,0.14,0.6
1737,LEADS,149236,18,10,0,10,0.56,0.0
960,LEADGID,27713,2,1,9,10,0.5,0.9
1401,LEADGID,70538,7,2,8,10,0.29,0.8
1702,LEADS,147362,4,2,8,10,0.5,0.8
1345,LEADGID,67613,8,7,3,10,0.88,0.3
1915,LEADS,159428,22,9,1,10,0.41,0.1
933,LEADGID,25259,16,7,3,10,0.44,0.3
1904,LEADS,158624,21,9,1,10,0.43,0.1
93992,UNICOM24,106840,15,9,1,10,0.6,0.1
2088,LEADS,48687,14,3,7,10,0.21,0.7
534,GURU,2448,6,2,8,10,0.33,0.8
