,partner,sub3,reg,new,rep,total,ARn,RLS
1159,LEADGID,58461,1717,848,2446,3294,0.49,0.742562234365513
41836,RAFINAD,,1597,605,1313,1918,0.38,0.6845672575599583
856,LEADGID,12950,673,307,835,1142,0.46,0.7311733800350263
1734,LEADS,154244,1687,895,215,1110,0.53,0.19369369369369369
1152,LEADGID,57766,431,233,767,1000,0.54,0.767
66742,UNICOM24,41476,1212,677,207,884,0.56,0.2341628959276018
1009,LEADGID,33203,466,249,438,687,0.53,0.6375545851528385
260,CITYADS,5eDh,51,187,429,616,3.67,0.6964285714285714
469,GURU,121,497,193,338,531,0.39,0.6365348399246704
967,LEADGID,29873,114,127,399,526,1.11,0.7585551330798479
1637,LEADS,148076,114,96,421,517,0.84,0.8143133462282398
1161,LEADGID,58463,182,120,348,468,0.66,0.7435897435897436
226,ARHIP,,32,334,130,464,10.44,0.2801724137931034
488,GURU,1633,666,195,257,452,0.29,0.5685840707964602
1390,LEADGID,8622,580,217,231,448,0.37,0.515625
931,LEADGID,26769,395,172,261,433,0.44,0.6027713625866051
1157,LEADGID,58238,564,231,187,418,0.41,0.4473684210526316
577,GURU,3614,780,321,61,382,0.41,0.15968586387434555
328,CITYADS,sp3,70,103,223,326,1.47,0.6840490797546013
1050,LEADGID,37193,156,97,212,309,0.62,0.686084142394822
19,ADMITAD,1146051,65,72,215,287,1.11,0.7491289198606271
144,ADMITAD,52519,96,151,120,271,1.57,0.44280442804428044
147,ADMITAD,539733,124,166,85,251,1.34,0.3386454183266932
959,LEADGID,28789,143,59,183,242,0.41,0.756198347107438
854,LEADGID,12428,77,109,115,224,1.42,0.5133928571428571
1065,LEADGID,37913,70,47,159,206,0.67,0.7718446601941747
1522,LEADS,137169,72,47,158,205,0.65,0.7707317073170732
849,LEADGID,10392,113,52,146,198,0.46,0.7373737373737373
1889,LEADS,17890,41,55,136,191,1.34,0.7120418848167539
1388,LEADGID,75490,97,56,123,179,0.58,0.6871508379888268
1620,LEADS,146789,284,134,35,169,0.47,0.20710059171597633
627,GURU,4680,348,158,7,165,0.45,0.04242424242424243
1625,LEADS,147178,72,33,131,164,0.46,0.7987804878048781
1160,LEADGID,58462,74,37,113,150,0.5,0.7533333333333333
981,LEADGID,32183,84,58,87,145,0.69,0.6
237,CITYADS,27EF,27,52,71,123,1.93,0.5772357723577236
1704,LEADS,152795,64,31,91,122,0.48,0.7459016393442623
1043,LEADGID,36443,57,31,90,121,0.54,0.743801652892562
1635,LEADS,147990,37,23,96,119,0.62,0.8067226890756303
1982,LEADS,46928,211,108,3,111,0.51,0.02702702702702703
1662,LEADS,149351,20,16,90,106,0.8,0.8490566037735849
1026,LEADGID,35153,4,77,21,98,19.25,0.21428571428571427
313,CITYADS,mwxJzG,109,51,47,98,0.47,0.47959183673469385
668,GURU,5808,14,12,84,96,0.86,0.875
586,GURU,3793,16,11,85,96,0.69,0.8854166666666666
1233,LEADGID,64416,143,88,5,93,0.62,0.053763440860215055
1448,LEADS,127377,16,15,76,91,0.94,0.8351648351648352
1458,LEADS,128457,18,10,79,89,0.56,0.8876404494382022
1677,LEADS,150413,38,16,71,87,0.42,0.8160919540229885
190,ADMITAD,960004,4,22,62,84,5.5,0.7380952380952381
1577,LEADS,142813,156,64,18,82,0.41,0.21951219512195122
600,GURU,4085,34,20,62,82,0.59,0.7560975609756098
645,GURU,5051,56,21,59,80,0.38,0.7375
2014,LEADS,50985,132,73,6,79,0.55,0.0759493670886076
1001,LEADGID,32723,40,18,60,78,0.45,0.7692307692307693
1488,LEADS,132630,39,11,62,73,0.28,0.8493150684931506
1554,LEADS,140766,20,15,57,72,0.75,0.7916666666666666
1147,LEADGID,57343,32,17,55,72,0.53,0.7638888888888888
1784,LEADS,157560,11,13,58,71,1.18,0.8169014084507042
670,GURU,5811,21,15,51,66,0.71,0.7727272727272727
1561,LEADS,141105,39,14,49,63,0.36,0.7777777777777778
1140,LEADGID,56192,6,8,55,63,1.33,0.873015873015873
1649,LEADS,148651,20,9,51,60,0.45,0.85
985,LEADGID,32281,27,14,45,59,0.52,0.7627118644067796
1462,LEADS,128702,15,16,43,59,1.07,0.7288135593220338
2063,LEADS,75911,30,18,40,58,0.6,0.6896551724137931
474,GURU,1484,87,39,19,58,0.45,0.3275862068965517
1595,LEADS,144910,95,44,10,54,0.46,0.18518518518518517
41737,LIKNOT,4574,79,54,0,54,0.68,0.0
965,LEADGID,29519,21,8,42,50,0.38,0.84
1647,LEADS,148603,21,8,41,49,0.38,0.8367346938775511
1881,LEADS,168868,23,14,32,46,0.61,0.6956521739130435
1533,LEADS,138800,4,7,39,46,1.75,0.8478260869565217
1062,LEADGID,37901,31,12,34,46,0.39,0.7391304347826086
1412,LEADS,124106,25,7,37,44,0.28,0.8409090909090909
527,GURU,2452,22,6,37,43,0.27,0.8604651162790697
1653,LEADS,148925,7,9,34,43,1.29,0.7906976744186046
66576,UNICOM24,16233,15,18,25,43,1.2,0.5813953488372093
1536,LEADS,139154,58,40,2,42,0.69,0.047619047619047616
1168,LEADGID,59189,16,12,30,42,0.75,0.7142857142857143
2050,LEADS,66417,5,8,34,42,1.6,0.8095238095238095
1429,LEADS,125355,33,15,26,41,0.45,0.6341463414634146
1685,LEADS,151237,65,41,0,41,0.63,0.0
1041,LEADGID,36435,41,14,27,41,0.34,0.6585365853658537
1049,LEADGID,37191,33,13,28,41,0.39,0.6829268292682927
114,ADMITAD,2506,24,35,6,41,1.46,0.14634146341463414
1419,LEADS,124578,20,15,25,40,0.75,0.625
1024,LEADGID,35041,18,11,29,40,0.61,0.725
314,CITYADS,nZypxl,75,38,1,39,0.51,0.02564102564102564
42050,SALEADS,de5ed0d0-c98f-11e9-9356-13b4824cb393,56,39,0,39,0.7,0.0
1433,LEADS,125754,17,11,28,39,0.65,0.717948717948718
1258,LEADGID,66345,5,8,30,38,1.6,0.7894736842105263
582,GURU,3767,3,2,36,38,0.67,0.9473684210526315
1781,LEADS,157527,22,9,29,38,0.41,0.7631578947368421
1531,LEADS,138622,46,31,4,35,0.67,0.11428571428571428
658,GURU,5440,72,33,2,35,0.46,0.05714285714285714
1558,LEADS,140837,22,10,24,34,0.45,0.7058823529411765
1265,LEADGID,66493,42,27,7,34,0.64,0.20588235294117646
66756,UNICOM24,70740,44,29,4,33,0.66,0.12121212121212122
1261,LEADGID,66486,16,9,24,33,0.56,0.7272727272727273
1738,LEADS,154584,54,30,2,32,0.56,0.0625
1529,LEADS,138336,22,8,24,32,0.36,0.75
1930,LEADS,29269,27,11,20,31,0.41,0.6451612903225806
1602,LEADS,145787,57,29,2,31,0.51,0.06451612903225806
1917,LEADS,23706,72,11,20,31,0.15,0.6451612903225806
1263,LEADGID,66489,41,29,2,31,0.71,0.06451612903225806
1808,LEADS,158407,51,29,2,31,0.57,0.06451612903225806
691,GURU,6356,15,7,24,31,0.47,0.7741935483870968
1498,LEADS,133972,21,13,17,30,0.62,0.5666666666666667
41914,REGBET,1738,56,12,18,30,0.21,0.6
1670,LEADS,149842,55,29,1,30,0.53,0.03333333333333333
2013,LEADS,50944,44,29,1,30,0.66,0.03333333333333333
1711,LEADS,153044,34,27,2,29,0.79,0.06896551724137931
1861,LEADS,164383,52,28,1,29,0.54,0.034482758620689655
302,CITYADS,X6K4OA,54,28,1,29,0.52,0.034482758620689655
879,LEADGID,21627,36,18,11,29,0.5,0.3793103448275862
1642,LEADS,148452,32,17,12,29,0.53,0.41379310344827586
1421,LEADS,124688,10,11,18,29,1.1,0.6206896551724138
1440,LEADS,126547,5,4,25,29,0.8,0.8620689655172413
908,LEADGID,24711,5,6,23,29,1.2,0.7931034482758621
924,LEADGID,25799,10,6,23,29,0.6,0.7931034482758621
2015,LEADS,50988,0,7,21,28,inf,0.75
2036,LEADS,53345,12,8,19,27,0.67,0.7037037037037037
689,GURU,6321,7,7,20,27,1.0,0.7407407407407407
1521,LEADS,136422,60,25,1,26,0.42,0.038461538461538464
1641,LEADS,148401,28,19,7,26,0.68,0.2692307692307692
1593,LEADS,144779,37,24,1,25,0.65,0.04
1240,LEADGID,64845,31,23,2,25,0.74,0.08
1848,LEADS,162240,51,21,3,24,0.41,0.125
1570,LEADS,141913,35,23,1,24,0.66,0.041666666666666664
502,GURU,2071,9,6,18,24,0.67,0.75
559,GURU,3350,10,4,20,24,0.4,0.8333333333333334
1621,LEADS,146840,42,22,2,24,0.52,0.08333333333333333
2062,LEADS,75828,15,8,16,24,0.53,0.6666666666666666
596,GURU,4036,12,6,17,23,0.5,0.7391304347826086
2035,LEADS,53292,8,8,15,23,1.0,0.6521739130434783
1329,LEADGID,70098,3,2,21,23,0.67,0.9130434782608695
1480,LEADS,130978,5,2,21,23,0.4,0.9130434782608695
1279,LEADGID,67375,5,7,16,23,1.4,0.6956521739130435
266,CITYADS,76KGrr,8,8,15,23,1.0,0.6521739130434783
1417,LEADS,124482,12,7,16,23,0.58,0.6956521739130435
986,LEADGID,32283,9,4,18,22,0.44,0.8181818181818182
262,CITYADS,5ohl,21,6,16,22,0.29,0.7272727272727273
1503,LEADS,134438,7,5,16,21,0.71,0.7619047619047619
702,GURU,6658,19,5,16,21,0.26,0.7619047619047619
1612,LEADS,146348,19,12,9,21,0.63,0.42857142857142855
1544,LEADS,140234,8,11,10,21,1.38,0.47619047619047616
972,LEADGID,30979,7,6,15,21,0.86,0.7142857142857143
1472,LEADS,130391,9,7,14,21,0.78,0.6666666666666666
1782,LEADS,157551,8,8,13,21,1.0,0.6190476190476191
1346,LEADGID,70543,11,8,13,21,0.73,0.6190476190476191
1785,LEADS,157563,5,6,15,21,1.2,0.7142857142857143
1713,LEADS,153162,7,4,16,20,0.57,0.8
1249,LEADGID,65981,25,19,1,20,0.76,0.05
1334,LEADGID,70370,39,18,2,20,0.46,0.1
756,GURU,9687,29,20,0,20,0.69,0.0
1779,LEADS,157504,8,3,17,20,0.38,0.85
1124,LEADGID,52624,21,19,1,20,0.9,0.05
565,GURU,3434,35,18,2,20,0.51,0.1
305,CITYADS,Z4M21E,22,19,1,20,0.86,0.05
1543,LEADS,140208,17,5,14,19,0.29,0.7368421052631579
1416,LEADS,124449,5,3,16,19,0.6,0.8421052631578947
41855,RAFINAD,1778,5,2,17,19,0.4,0.8947368421052632
1017,LEADGID,34179,5,2,16,18,0.4,0.8888888888888888
1884,LEADS,1698,6,4,14,18,0.67,0.7777777777777778
574,GURU,3563,29,14,4,18,0.48,0.2222222222222222
595,GURU,4031,9,4,14,18,0.44,0.7777777777777778
2020,LEADS,51414,7,6,12,18,0.86,0.6666666666666666
564,GURU,3429,66,7,11,18,0.11,0.6111111111111112
1205,LEADGID,61672,7,4,13,17,0.57,0.7647058823529411
941,LEADGID,27713,4,2,15,17,0.5,0.8823529411764706
1148,LEADGID,57368,10,2,15,17,0.2,0.8823529411764706
604,GURU,4092,11,7,10,17,0.64,0.5882352941176471
338,CLICK2MONEY,108,1,6,11,17,6.0,0.6470588235294118
41900,RAFINAD,668,7,7,10,17,1.0,0.5882352941176471
41903,RAFINAD,672,5,6,10,16,1.2,0.625
1042,LEADGID,36439,11,8,8,16,0.73,0.5
1076,LEADGID,38747,24,12,4,16,0.5,0.25
1021,LEADGID,34553,5,2,14,16,0.4,0.875
1880,LEADS,168022,24,16,0,16,0.67,0.0
1812,LEADS,158625,27,13,2,15,0.48,0.13333333333333333
1514,LEADS,135211,18,14,1,15,0.78,0.06666666666666667
41781,PDL-PROFIT,17662,21,10,5,15,0.48,0.3333333333333333
1340,LEADGID,70536,8,6,9,15,0.75,0.6
2010,LEADS,50567,27,14,1,15,0.52,0.06666666666666667
847,LEADCRAFT,fb4e4548-f279-4178-b87a-29e6b07c084a,5,3,12,15,0.6,0.8
1179,LEADGID,59539,6,3,12,15,0.5,0.8
1775,LEADS,157214,4,4,11,15,1.0,0.7333333333333333
352,CLICK2MONEY,2560,21,15,0,15,0.71,0.0
968,LEADGID,30061,7,5,10,15,0.71,0.6666666666666666
41790,PDL-PROFIT,22199,18,13,1,14,0.72,0.07142857142857142
648,GURU,5142,27,13,1,14,0.48,0.07142857142857142
1210,LEADGID,61999,19,13,1,14,0.68,0.07142857142857142
716,GURU,7125,20,14,0,14,0.7,0.0
1821,LEADS,159663,16,13,1,14,0.81,0.07142857142857142
690,GURU,6333,4,2,12,14,0.5,0.8571428571428571
921,LEADGID,25717,4,2,12,14,0.5,0.8571428571428571
41691,LEADTARGET,1218,24,10,4,14,0.42,0.2857142857142857
41878,RAFINAD,2629,14,10,4,14,0.71,0.2857142857142857
1426,LEADS,125066,8,5,9,14,0.62,0.6428571428571429
1154,LEADGID,57865,6,2,12,14,0.33,0.8571428571428571
1904,LEADS,20602,12,5,9,14,0.42,0.6428571428571429
1645,LEADS,148540,1,3,11,14,3.0,0.7857142857142857
1262,LEADGID,66488,8,7,7,14,0.88,0.5
1786,LEADS,157579,4,3,11,14,0.75,0.7857142857142857
1627,LEADS,147430,20,10,3,13,0.5,0.23076923076923078
1780,LEADS,157506,2,5,8,13,2.5,0.6153846153846154
1362,LEADGID,71801,18,13,0,13,0.72,0.0
1166,LEADGID,58993,5,3,10,13,0.6,0.7692307692307693
278,CITYADS,Bg0MrW,21,13,0,13,0.62,0.0
372,CLICK2MONEY,4740,19,13,0,13,0.68,0.0
376,CLICK2MONEY,4940,27,13,0,13,0.48,0.0
1330,LEADGID,70218,13,11,2,13,0.85,0.15384615384615385
558,GURU,3344,17,8,5,13,0.47,0.38461538461538464
2008,LEADS,50080,7,4,9,13,0.57,0.6923076923076923
1422,LEADS,124699,25,11,1,12,0.44,0.08333333333333333
66624,UNICOM24,174711,18,12,0,12,0.67,0.0
1599,LEADS,145563,18,11,1,12,0.61,0.08333333333333333
66655,UNICOM24,176552,23,11,1,12,0.48,0.08333333333333333
1348,LEADGID,70545,10,3,9,12,0.3,0.75
1765,LEADS,157094,3,3,9,12,1.0,0.75
1207,LEADGID,61747,7,3,9,12,0.43,0.75
1453,LEADS,127637,15,11,1,12,0.73,0.08333333333333333
1442,LEADS,126801,6,2,10,12,0.33,0.8333333333333334
1324,LEADGID,69705,19,11,1,12,0.58,0.08333333333333333
988,LEADGID,32337,7,1,11,12,0.14,0.9166666666666666
1697,LEADS,152418,14,12,0,12,0.86,0.0
1803,LEADS,158156,14,11,1,12,0.79,0.08333333333333333
202,ADVERTISE,151220,6,12,0,12,2.0,0.0
1120,LEADGID,50378,10,5,7,12,0.5,0.5833333333333334
541,GURU,2887,22,12,0,12,0.55,0.0
459,GURU,10438,20,12,0,12,0.6,0.0
1679,LEADS,150745,18,11,0,11,0.61,0.0
1837,LEADS,161400,8,11,0,11,1.38,0.0
998,LEADGID,32663,0,0,11,11,,1.0
1820,LEADS,159626,16,11,0,11,0.69,0.0
1444,LEADS,127104,25,11,0,11,0.44,0.0
1264,LEADGID,66491,8,2,9,11,0.25,0.8181818181818182
1834,LEADS,161152,12,11,0,11,0.92,0.0
1794,LEADS,157869,1,4,7,11,4.0,0.6363636363636364
1437,LEADS,126448,6,4,7,11,0.67,0.6363636363636364
709,GURU,6962,3,2,9,11,0.67,0.8181818181818182
2027,LEADS,52596,7,3,8,11,0.43,0.7272727272727273
1364,LEADGID,71831,14,9,2,11,0.64,0.18181818181818182
383,CLICK2MONEY,5402,11,9,2,11,0.82,0.18181818181818182
718,GURU,7208,21,9,2,11,0.43,0.18181818181818182
1795,LEADS,157914,0,1,10,11,inf,0.9090909090909091
128,ADMITAD,44143,1,2,8,10,2.0,0.8
8116,LEADSTECH,27,19,8,2,10,0.42,0.2
1418,LEADS,124551,6,4,6,10,0.67,0.6
1431,LEADS,125635,0,3,7,10,inf,0.7
970,LEADGID,30711,3,3,7,10,1.0,0.7
1347,LEADGID,70544,10,3,7,10,0.3,0.7
65438,UNICOM24,106840,15,9,1,10,0.6,0.1
1169,LEADGID,59191,6,2,8,10,0.33,0.8
1482,LEADS,131043,17,10,0,10,0.59,0.0
1332,LEADGID,70220,12,10,0,10,0.83,0.0
1626,LEADS,147362,4,2,8,10,0.5,0.8
1710,LEADS,153043,20,10,0,10,0.5,0.0
1703,LEADS,152773,19,10,0,10,0.53,0.0
1342,LEADGID,70539,6,1,9,10,0.17,0.9
927,LEADGID,26087,23,10,0,10,0.43,0.0
1002,LEADGID,32727,15,7,3,10,0.47,0.3
41858,RAFINAD,1781,2,1,9,10,0.5,0.9
41842,RAFINAD,116,3,0,10,10,0.0,1.0
1818,LEADS,159428,22,9,1,10,0.41,0.1
